5
#######
# $ ..#
#  $  #
#     #
#######
