5
########
# .    #
# $    #
#    @ #
########
