6
########
#   # .#
#   $$.#
####   #
#@   ###
######